************************************************************
|                                                          |
|                                                          |
|                                                          |
|                                                          |
|                                                          |
|       @       @       @       @       @       @          |
|                                                          |
|                                                          |
|           @       @       @       @       @              |
|                                                          |
|                                                          |
|       @       @       @       @       @       @          |
|                                                          |
|                                                          |
|           @       @       @       @       @              |
|                                                          |
|                                                          |
|                                                          |
|                                                          |
|        ###         ###         ###          ###          |
|       #####       #####       #####        #####         |
|       #####       #####       #####        #####         |
|                                                          |
|                                                          |
|                                                          |
|                                                          |
|                                                          |
|                                                          |
************************************************************
